 
 ####################### 
 #     ###             # 
 #     #               # 
 #     #               # 
 #                     # 
 #                     # 
 #                     # 
 #                     # 
 #                 ##### 
 #     #           ##### 
 #    ##           ##### 
 ####################### 
                         
